1111111111111111
1____________1_1
1__1111___111__1
1_____1_____1__1
1_____1_____1__1
1__1111________1
1______________1
1___1______1___1
1111111111111111